CTTTTTTTTTTTTTTTTTTTTTTTTTTTTTTTTTTTTTTc
lLLLLLLLLLLLLLLLLLLLLLLLLLLLLLLLLLLLLLLr
lLLLLLLhRRRRRRkLLLLLLLLLLLLLLLLLLLLLLLLr
lLLLLLLjtLLLLtjLLLLLLLLLLLLLLLLLLLLLLLLr
lLLLLLLjtLLLLtjLLLLLLLLLLLLLLLLLLLLLLLLr
lLLLLLLjtLLLLtjLLLLLLLLLLLLLLLLLLLLLLLLr
RRRRRRRftLLLLtjtLLLLLLLLLLtttttttttLLLLr
lLLLLLLLLLLLLLjtLLLLLLLLLthRRRRRRRRRRRRR
lLLLLLLLLLLLLLjtLLLLLLLLLtjLLLLLLLLLLLLr
lLLLLLLLLLLLLLjtLLLLLLLLLtjLLLLLLLLLLLLr
lLLLLLLLLLLLLLjtLLLLLLLLLtjLLLLLLLLLLLLr
lLLLLLLLLLLLLLjtttttttttttjLLLLLLLLLLLLr
lLLLLLLLLLLLLLyRRRRRRRRRRRfLLLLLLLLLLLLr
lLLLLLLLLLLLLLLLLLLLLLLLLLLLLLLLLLLLLLLr
lLLLLLLLLLLLLLLLLLLLLLLLLLLLLLLLLLLLLLLr
lLLLLLLLLLLLLLLLLLLLLLLLLLLLLLLLLLLLLLLr
lLLLLLLLLLLLLLLLLLLLLLLLLLLLLLLLLLLLLLLr
lLLLLLLLLLLLLLLLLLLLLLLLLLLLLLLLLLLLLLLr
lLLLLLLLLLLLLLLLLLLLLLLLLLLLLLLLLLLLLLLr
lLLLLLLLLLLLLLLLLLLLLLLLLLLLLLLLLLLLLLLr
gBBBBBBBBBBBBBBBBBBBBBBBBBBBBBBBBBBBBBBG
