CTTTTTTTTTTTTTTTTTTTTTTTTTTTTTTTTTTTTTTc
lLLLLLLLLLLLLLLLLLLLLLLLLLLLLLLLLLLLLLLr
lLLLLLLLLLLLLLLLLLLLLLLLLLLLLLLLLLLLLLLr
lLLLLLLLLLLLLLLLLLLLLLLLLLLLLLLLLLLLLLLr
lLLLLLLLLLLLLLLLLLLLLLLLLLLLLLLLLLLLLLLr
lLLLLLLLLLLLLLLLLLLLLLLLLLLLLLLLLLLLLLLr
RRRRRRRkLLLLLLLLLLLLLLLLLLLLLLLLLLLLLLLr
lLLLLLLjLLLLLLLLLLLLLLLLLLhRRRRRRRRRRRRR
lLLLLLLjLLLLLLLLLLLLLLLLLLjLLLLLLLLLLLLr
lLLLLLLjLLLLLLLLLLLLLLLLLLjLLLLLLLLLLLLr
lLLLLLLjLLLLLLLLLLLLLLLLLLjLLLLLLLLLLLLr
lLLLLLLjLLLLLLhRRRRRRRRRRRfLLLLLLLLLLLLr
lLLLLLLjLLLLLLjtttttttttttLLLLLLLLLLLLLr
lLLLLLLjLLLLLLjLLLLLLLLLLLLLLLLLLLLLLLLr
lLLLLLLjLLLLLLjLLLLLLLLLLLLLLLLLLLLLLLLr
lLLLLLLjLLLLLLjLLLLLLLLLLLLLLLLLLLLLLLLr
lLLLLLLjLLLLLLjLLLLLLLLLLLLLLLLLLLLLLLLr
lLLLLLLyRRRRRRfLLLLLLLLLLLLLLLLLLLLLLLLr
lLLLLLLLttttttLLLLLLLLLLLLLLLLLLLLLLLLLr
lLLLLLLLLLLLLLLLLLLLLLLLLLLLLLLLLLLLLLLr
gBBBBBBBBBBBBBBBBBBBBBBBBBBBBBBBBBBBBBBG
