CTTTTTTTTTTTTTTTTTTTTTTTTTTTTTTTTTTTTTTc
lLLLLLLLLLLLLLLLLLLLLLLLLLLLLLLLLLLLLLLr
lLLLLLLLLLLLLLLLLLLLLLLLLLLLLLLLLLLLLLLr
lLLLhRRRRRkLLLLLLLLLLLLLLLLLLLLLLLLLLLLr
lLLLjLLLLLjLLLLLLLLLLLLLLLLLLLLLLLLLLLLr
lLLLjLLLLLjLLLLLLLLLhRRRRRRRRRRRRkLLLLLr
RRRRfLLLLLjLLLLLLLLLjLLLLLLLLLLLLjLLLLLr
lLLLLLLLLLjLLLLLLLLLjLLLLLLLLLLLLjLLLLLr
lLLLLLLLLLjLLLLLLLLLjLLLLLLLLLLLLjLLLLLr
lLLLLLLLLLyRRRRRRRRRfLLLLLLLLLLLLjLLLLLr
lLLLLLLLLLLLLLLLLLLLLLLLLLLLLLLLLjLLLLLr
lLLLLLLLLLLLLLLLLLLLLLLLLLLLLLLLLjLLLLLr
lLLLLLLLLLLLLLLLLLLLLLLLLLLLLLLLLjLLLLLr
lLLLLLLLLLLLLLLLLLLLLLLLLLLLLLLLLjLLLLLr
lLLLLLLLLLLLLLLLLLLLLLLLLLLLLLLLLjLLLLLr
lLLLLLLLLLLLLLLLLLLLLLLLLLLLLLLLLjLLLLLr
lLLLLLLLLLLLLLLLLLLLLLLLLLLLLLLLLyRRRRRR
lLLLLLLLLLLLLLLLLLLLLLLLLLLLLLLLLLLLLLLr
lLLLLLLLLLLLLLLLLLLLLLLLLLLLLLLLLLLLLLLr
lLLLLLLLLLLLLLLLLLLLLLLLLLLLLLLLLLLLLLLr
gBBBBBBBBBBBBBBBBBBBBBBBBBBBBBBBBBBBBBBG
