CTTTTTTTTTTTTTTTTTTTTTTTTTTTTTTTTTTTTTTc
lLLLLLLLLLLLLLLLLLLLLLLLLLLLLLLLLLLLLLLr
lLLLLLLLLLLLLLLLLLLLLLLLLLLLLLLLLLLLLLLr
lLLLLLLLLLLLhRRRRRRRRRRRRRRRRRRRRRRRRRRR
lLLLLLLLLLLLjLLLLLLLLLLLLLLLLLLLLLLLLLLr
lLLLLLLLLLLLjLLLLLLLLLLLLLLLLLLLLLLLLLLr
RRRRRRRkLLLLjLLLLLLLLLLLLLLLLLLLLLLLLLLr
lLLLLLLjLLLLyRRRRRRRRRRRRRkLLLLLLLLLLLLr
lLLLLLLjLLLLLLLLLLLLLLLLLLjLLLLLLLLLLLLr
lLLLLLLjLLLLLLLLLLLLLLLLLLjLLLLLLLLLLLLr
lLLLLLLjLLLLLLLLLLLLLLLLLLjLLLLLLLLLLLLr
lLLLLLLjLLLLLLhRRRRRRRRRRRfLLLLLLLLLLLLr
lLLLLLLjLLLLLLjLLLLLLLLLLLLLLLLLLLLLLLLr
lLLLLLLjLLLLLLjLLLLLLLLLLLLLLLLLLLLLLLLr
lLLLLLLjLLLLLLjLLLLLLLLLLLLLLLLLLLLLLLLr
lLLLLLLjLLLLLLjLLLLLLLLLLLLLLLLLLLLLLLLr
lLLLLLLjLLLLLLjLLLLLLLLLLLLLLLLLLLLLLLLr
lLLLLLLyRRRRRRfLLLLLLLLLLLLLLLLLLLLLLLLr
lLLLLLLLLLLLLLLLLLLLLLLLLLLLLLLLLLLLLLLr
lLLLLLLLLLLLLLLLLLLLLLLLLLLLLLLLLLLLLLLr
gBBBBBBBBBBBBBBBBBBBBBBBBBBBBBBBBBBBBBBG
