CTTTTTTTTTTTTTTTTTTTTTTTTTTTTTTTTTTTTTTc
lLLLLLLLLLLLLLLLLLLLLLLLLLLLLLLLLLLLLLLr
lLLLLLLLLLLLLLLLLLLLLLLLLLLLLLLLLLLLLLLr
lLLLLLLLLLLLhRRRRRRRRRRRRRRRRRRRRRRRRRRR
lLLLLLLLLLLLjLLLLLLLLLLLLLLLLLLLLLLLLLLr
lLLLLLLLLLLLjLLLLLLLLLLLLLLLLLLLLLLLLLLr
RRRRRRRkLLLLjLLLLLLLLLLLLLLLLLLLLLLLLLLr
lLLLLLLjLLLLyRRRRRRRRRRRRRkLLLLLLLLLLLLr
lLLLLLLjLLLLLLLLLLLLLLLLLLjLLLLLLLLLLLLr
lLLLLLLjLLLLLLLLLLLLLLLLLLyRRRRRRRkLLLLr
lLLLLLLjLLLLLLLLLLLLLLLLLLLLLLLLLLjLLLLr
lLLLLLLjLLLLLLLLLLLLLLLLLLLLLLLLLLjLLLLr
lLLLLLLjLLLLLLLLLLLLLLLLLLLLLLLLLLjLLLLr
lLLLLLLjLLLLLLLLLLLLLLLLLLLLLLLLLLjLLLLr
lLLLLLLjLLLLLLLLLLLLLLLLLLLLLLLLLLjLLLLr
lLLLLLLjLLLLLLLLLLLLLLLLLLLLLLLLLLjLLLLr
lLLLLLLjLLLLLLLLLLLLLLLLLLLLLLLLLLjLLLLr
lLLLLLLyRRRRRRRRRRRRRRRRRRRRRRRRRRfLLLLr
lLLLLLLLLLLLLLLLLLLLLLLLLLLLLLLLLLLLLLLr
lLLLLLLLLLLLLLLLLLLLLLLLLLLLLLLLLLLLLLLr
gBBBBBBBBBBBBBBBBBBBBBBBBBBBBBBBBBBBBBBG
