2
                         7    
             @           2    
             8           2    
             2           2    
             2           2    
             2           2    
  @@@@@@@@@@@2@@@@@@@@@@@2    
  611111111111111111111114    
  2                           
  2         @                 
  2         8                 
  2         2                 
  2         2                 
  2         2                 
  2         2                 
  2         2                 
  2  @@@@@@@2                 
  2  61111115                 
  2  2      2@@@@@@@@@@       
  2@@2@A@A@ 2111111111>       
  311400000 2                 
            2                 
   @@@@@@@@@2@@@@@@@@@@@@A   
   <1111111131111111111115    
                         2    
                         2    
                         2    
                         2    
                         2    
                              
