3
             7                
             2                
     @@@@@@A@2@A@@@@@@@@@@    
     611111113111111111115    
     2                   2    
     2@@A@@@@@@@@@ @A@@@@2    
     211111111111> 1111112    
     2      2            2    
     2      2            2    
     2      2@A@@@@@@@A@@2    
     2      61111111111114    
     2@@@@@@2      @@@@@@2    
     31111112      6111112    
            2@@@@@@2@    2    
   @@A@@@@@@21111111>    2  
   6111111114            2  
   2        2            2  
   2       @2@@@@@@@@A@@@2  
   2       <31111611111114    
   2             2            
   2@A@@@@@@@    2            
   3111111115    2            
     2      2    2            
     2      2    2            
     2      2    2            
     2      2@@@@2@@@@@@@A    
     2      31111111111115    
     2                   2    
     :                   2    
                         2    
                         2    
                              N@
