f
   7 
DBB2BBBBBBBBBBBBBBBBBBB@BBBC
D0020000000000000000000@000C
D0031111111111115000000@000C
D0000000D2C000002000000A000C
D0000000D2C000002111111A11>C
D0000000D2C000002000000A000C
D0000000D2BBBBBB2000000@000C
D00B:B00D31111112000000@000C
D000B000D2BBBBBB2000000@0B0C
D0000000D2C000002000000@B8BC
DBBBBBBBB2C000002000000@000C
D0000611111111114000000@000C
D0000200000000000000000@000C
D0000200000000000000000@000C
D0000200000000000000000@000C
D0000311111111150000000@000C
D0000000000000020000000@000C
D0000000000000020000000A000C
D0000000000000031111111A111C
D0000200000000000000000A000C
D0000200000000000000000@000C
D00<1400000000000000000@000C
DBBBBBBBBBBBBBBBBBBBBBB@BBBC
