32
IIIIIIIIIIIIIIIIIIIIIIII
IIIIIIIIIIIIIIIIIIIIIIII
IIIPIIIIIIPIIKIIIIIIIIII
IIPIPIIPIIIIIIIIIILIIIII
IIIPIIEBBBBFIIIIIIINIIII
IIOOIIAIILICIIIIIIIPPIII
RBBBBBGILLLCIMIIEBBBBBFI
IIIIIIPIILICIIMIAIIMIICI
INIIIIIIIIICIMIIAIILIIHB
IINIEDDDDDDGIIMIAILLLIII
IIIICIOIIIIPIIIIAIILIIII
IIIIHBBBBBBBBBBBGIIIIIII
IIIIIIIOIIOIOIIOIIIIPIII
IIIIIIIIOIIOIIOIIIIIIIII
IIIMIIIIIIIIIIIIIIIIIIII
IIIIIIIIIIIIIIINIIIIIIII
IIIIIIIIIIIIIIIIIIIIIIII
IIIIIIIIIIIIIIIIIIIIIIII
IIIIIIIIIIIIIIIIIIIIIIII