10
IIIIIIIIIIIIIIIIIP
IIIIIIIPIIIIIIIIIP
IIIIIIIIIIIIMIIIIP
KIIIIIIIIIIIIIIIIP
DDDDDDDDDDDFIIIIIP
PIIIIMIIIIIAIIIIIP
IIIIIIIIIIIAIIOIIP
IIIIOIIIIIIAIIIIIP
IIIIIIIIPIIAIMIIIP
IIIIIIIEBBBGIIIIIP
IINIIIIAIIINIIIIIP
IIIIIINAIIIIKIIIIP
IIIIIIMAOIIIIIIIIP
IIIIIIIQNIIIIIIIIP