                                                                            CAAAAE                                                                              
                                                                            CAAAAE                                                   Q NOP                      
                                                                            CAAAAE                                                NOOP                          
                                                                            CAAAAE                                          NOP             DFSSSDF    DBF      
                                                            Q               KLLLLM                                    NOP                   CERRRCE    KLM      
                   Q           QQ                    DBBBBBBF                                                   DBF                         CERRRCEQQQQQQQQQQ   
BBBBBBBBBBBBBBBBBBBBBBBBBBBBBBBBBBBBBBBBBBBBBBBBBBBBGHAAAAAAIJBBBBBBBBBBBBBBBBBBBBBBBBFSSSDBBBBBBBF   DBBBBBBBBGHAIJBBBBBF                  CIJBGHIBBBBBBBBBBBBB
