13
MQIIIIIIIIIIIIIIIIIIIIII
OCIIIIIIIIIIIIIIIIIIIIII
NHBBBBBBBBBBBBFIILIIIIII
MNKIMIIPIIPIPICIKIIIIIII
IIIEDDDDDDDDDDGIIIIOIIII
IIICIOIIIIIKNLIIIIIIIIII
INIHBBBBBBBBBBBBBBBFIIII
IIIIIKIIPIIOIIIILKICNIII
IIOIIIKIINIPINIINIICIIII
IIIIIIIIIIMIIIIPIIICNIII
IILLLEDDDDDDDDDDDDDGIIII
IILKICIKIIIPILIIOIIIIIII
IILIICIMIIIIIIIIIPPPIIII
IPEDDGMMMIIIIIIIIIIIIIII
PICIIMMMMMIIIIIIIIIIIIII
IIHBBBBBBBFIIIIIIIIIIIII
IIIIKIIIKLCIIIIIIIIIIIII
IIIIIKIKILCIIIIIIIIIIIII
IIIIIKIKILCIIIIIIIIIIIII